Name	Token
Death	DT
Neutral	NU
Walk	WL
Run	RN
Get Hit	GH
Town Neutral	TN
Town Walk	TW
Attack1	A1
Attack2	A2
Block	BL
Cast	SC
Throw	TH
Kick	KK
Skill1	S1
Skill2	S2
Skill3	S3
Skill4	S4
Dead	DD
Sequence	GH
Knock back	GH
